00210001
10011011
11001001
12003001
11111021